16 16 16 16 16 16 16 16 16 16 16 16 16 16 16 16 16 16 16 16 16 16 16 16 16 16 16 16 16 16 16 16 16 16 16 16 16 16 16 16 16 16 16 16 16 16 16 16 16 16 16 16 16 16 16 16 16 16 16 16 16 16 16 16 16 16 16 16 16 16 16 16 16 16 16 16 16 16 16 16 16 16 16 16 16 16 16 16 16 16 16 16 16 16 16 16 16 16 16 16
16 16 16 16 16 16 16 16 16 16 16 16 16 16 16 16 16 16 16 16 16 16 16 16 16 16 16 16 16 16 16 16 16 16 16 16 16 16 2 2 2 2 2 2 2 2 2 2 2 2 2 2 2 2 2 2 2 2 2 2 2 2 2 2 2 2 2 2 2 2 2 2 2 2 2 2 2 2 2 2 2 2 2 2 2 2 2 16 16 16 2 2 16 16 16 2 2 16 16 16
16 16 16 16 16 16 16 16 16 16 16 16 16 16 16 16 16 16 1 1 1 1 1 1 1 16 16 16 16 16 16 16 16 1 1 1 16 16 16 16 16 16 16 16 16 16 16 16 16 16 16 16 16 16 16 16 16 16 16 16 16 16 16 16 16 16 16 16 16 16 16 16 16 16 16 16 16 16 16 16 2 2 2 2 2 2 2 2 2 2 2 2 2 2 2 2 2 16 16 16
16 16 16 16 16 16 16 16 16 16 16 16 16 16 1 1 1 1 1 16 16 1 1 1 1 1 1 1 16 16 1 1 1 16 16 1 1 1 1 16 16 16 16 16 16 16 16 16 16 2 2 2 2 2 2 2 2 2 2 2 2 2 2 2 2 2 2 2 2 2 2 2 2 2 1 1 1 1 1 1 1 2 2 2 16 16 16 16 16 16 2 2 16 2 2 16 16 16 16 16
16 16 16 16 16 16 16 16 16 16 16 16 16 1 1 16 16 16 1 1 16 16 16 16 16 1 1 1 1 1 1 16 16 16 16 16 16 16 1 1 1 1 1 1 1 16 16 2 2 2 16 16 16 16 16 16 16 16 16 1 1 1 16 16 16 16 16 16 16 16 16 16 16 2 2 2 2 16 16 16 16 16 16 2 2 16 16 16 16 16 16 2 16 2 16 16 16 16 16 16
21 21 21 21 21 21 21 22 16 16 16 16 1 1 16 16 16 16 16 1 1 16 16 16 16 16 16 16 1 1 1 1 1 16 1 1 1 1 1 1 1 16 16 16 16 16 2 2 16 16 16 16 16 16 1 1 1 1 1 16 16 16 16 16 16 16 16 16 16 16 16 16 16 16 16 16 2 2 2 16 16 16 16 16 2 2 2 16 16 16 16 2 2 2 16 16 16 16 16 16
18 18 18 18 18 18 18 30 21 21 22 16 1 16 16 16 16 16 16 16 1 16 16 16 16 16 16 16 16 1 1 1 1 1 1 1 16 16 16 1 1 16 16 16 16 2 2 1 1 1 1 1 1 1 16 16 16 16 16 16 16 16 16 16 16 16 16 16 16 16 16 16 16 16 16 16 16 16 2 2 2 16 16 16 16 16 2 2 1 16 16 16 2 2 16 16 16 16 16 16
18 18 18 18 18 18 18 18 18 18 30 21 22 16 16 16 16 16 16 1 1 16 16 16 16 16 1 1 1 1 1 1 1 16 16 16 1 1 1 1 1 1 1 2 2 2 1 16 16 16 16 16 16 16 12 10 10 10 10 10 10 10 10 10 10 10 10 10 10 10 10 10 10 10 10 16 16 16 16 16 2 2 16 16 16 16 16 2 2 1 16 16 2 2 2 16 16 16 16 16
18 18 18 18 18 18 18 18 18 18 18 18 30 21 21 22 1 1 1 1 16 16 16 16 16 16 16 16 1 1 1 1 1 1 1 1 1 1 1 16 16 2 2 2 16 16 16 16 16 16 16 12 10 10 11 3 3 3 3 3 3 3 3 3 3 3 3 3 3 3 3 3 3 3 3 3 1 16 16 16 16 16 2 16 16 16 16 16 16 2 16 16 2 16 2 16 16 16 16 16
18 18 18 18 18 18 18 18 18 18 18 18 18 18 18 30 21 21 21 22 16 16 16 16 16 16 16 1 1 16 1 1 1 1 1 16 16 16 16 1 1 2 16 16 16 16 16 16 16 12 10 11 3 3 3 3 3 4 5 5 6 3 3 3 3 3 4 5 5 5 5 5 5 5 5 6 1 1 16 16 16 16 2 2 16 16 16 16 16 2 2 16 2 2 2 16 16 16 16 16
18 18 18 18 18 18 18 18 18 18 18 18 18 18 18 18 18 18 18 30 21 21 21 22 16 16 16 1 16 1 1 16 16 16 1 1 16 2 1 2 16 16 16 16 16 16 16 16 16 8 3 3 3 3 3 3 4 15 16 16 14 5 6 3 3 3 3 20 21 21 21 21 21 21 21 22 16 1 1 1 16 16 16 2 2 16 16 16 16 16 2 16 16 2 2 16 16 16 16 16
26 26 26 26 26 26 26 26 26 29 18 18 18 18 18 18 18 18 18 18 18 18 18 30 21 21 22 1 1 16 16 16 16 16 16 1 1 2 16 16 16 16 16 16 16 16 12 10 10 11 3 3 3 3 3 3 7 16 16 16 16 2 8 3 3 3 3 23 18 18 18 18 18 18 18 24 16 1 1 1 1 16 16 16 2 16 16 16 16 16 1 1 16 16 2 2 2 16 16 16
16 1 33 16 16 16 16 16 16 25 26 26 26 26 29 18 18 18 18 18 18 18 18 18 18 18 30 21 22 16 16 16 16 16 16 2 2 16 16 16 16 16 16 16 16 16 8 3 3 3 3 4 5 6 3 3 9 10 10 10 10 10 11 3 3 3 3 23 18 18 18 18 18 19 18 24 1 1 1 1 1 1 16 16 2 2 16 16 16 16 16 1 16 16 2 2 2 16 16 16
16 1 16 16 16 16 16 1 1 1 1 1 1 1 25 26 26 26 29 18 18 18 18 18 18 18 18 18 30 21 21 22 16 1 2 16 16 16 16 16 16 16 12 10 10 10 11 3 3 4 5 15 16 14 6 3 3 3 3 3 3 3 3 3 3 3 20 31 18 18 18 19 18 18 18 24 1 1 1 1 1 1 1 1 1 2 16 16 1 1 1 1 1 1 2 2 2 16 16 16
16 1 16 1 1 16 16 1 33 1 1 16 16 1 1 1 1 1 25 26 29 18 18 18 18 18 18 18 18 18 18 30 21 22 16 16 16 16 16 16 16 16 8 3 3 3 3 4 5 15 16 16 16 16 14 5 5 5 5 5 5 6 3 3 7 20 31 18 18 18 18 18 18 18 18 24 16 16 16 1 1 1 1 16 16 2 16 1 1 16 16 16 1 1 16 2 2 16 16 16
16 1 16 1 1 1 1 1 1 33 1 16 16 1 1 16 16 16 1 1 25 26 29 18 18 18 18 18 18 18 18 18 18 18 21 22 16 16 16 16 12 10 11 3 3 3 3 7 16 16 16 16 16 16 16 16 16 16 16 16 16 8 3 3 7 23 18 18 18 18 18 18 18 18 18 24 16 16 16 2 2 17 1 1 16 2 16 1 16 16 16 16 1 16 16 2 2 16 16 16
16 1 1 16 16 16 1 1 1 33 33 1 1 16 1 16 16 16 16 16 16 16 25 26 26 29 18 18 18 18 18 18 18 18 18 30 21 22 16 16 8 3 3 3 3 4 5 15 16 16 16 16 16 16 16 16 16 16 16 16 16 8 3 3 7 23 18 18 18 18 19 18 18 18 18 24 16 16 16 2 2 17 17 1 16 2 16 1 16 16 16 16 1 1 16 2 2 16 16 16
16 33 1 16 16 16 16 33 1 1 1 1 1 16 1 16 16 16 16 16 16 16 16 16 1 25 29 18 18 18 18 18 18 18 18 18 18 30 22 12 11 3 3 3 4 20 16 16 16 20 21 21 21 21 22 16 16 16 16 16 16 8 3 3 7 23 18 18 18 18 18 18 18 18 18 30 21 21 21 21 22 17 17 1 1 2 16 1 16 16 16 16 16 1 2 2 2 16 16 16
16 16 1 16 16 16 16 1 1 1 16 16 1 16 1 16 16 16 16 16 16 16 16 16 1 16 25 26 29 18 18 18 18 18 18 18 18 18 18 17 3 3 3 4 15 16 16 16 20 31 18 18 18 18 30 21 22 16 16 16 16 8 3 3 7 23 18 18 18 18 18 17 17 17 17 18 18 18 18 18 24 17 17 16 1 2 16 1 16 16 16 16 16 1 2 16 2 16 16 16
16 1 16 16 16 16 1 16 16 1 16 16 16 1 1 16 16 16 16 16 16 16 16 1 1 16 1 2 25 29 18 18 18 18 18 18 18 18 17 17 17 17 5 15 16 16 16 1 23 18 18 18 18 18 18 18 30 22 16 16 16 8 3 3 7 23 18 18 18 18 18 17 17 17 17 18 18 18 18 18 24 17 17 16 1 2 16 1 1 16 16 16 16 1 2 16 2 16 16 16
16 1 16 16 16 16 16 16 1 1 16 16 16 16 1 16 16 16 3 3 3 3 3 3 16 16 2 3 3 25 26 29 18 18 18 18 18 18 17 17 17 17 17 16 16 16 1 20 31 18 18 18 18 18 18 28 26 27 16 16 16 8 3 3 7 23 18 18 19 18 18 17 17 17 17 17 17 17 17 17 17 17 17 16 1 2 2 16 1 1 16 16 16 1 2 16 2 2 16 16
16 1 16 16 16 16 16 16 1 16 16 16 16 16 3 3 3 3 3 3 3 3 3 3 3 2 2 3 1 1 1 25 29 18 18 18 18 17 17 17 17 17 17 17 16 1 20 18 18 18 18 18 18 18 18 24 2 16 16 16 16 8 3 3 7 23 18 18 18 18 18 17 17 17 17 17 17 17 17 17 17 17 17 16 16 1 2 16 16 16 1 1 16 2 2 16 16 2 16 16
16 3 3 3 3 3 3 3 3 3 3 3 3 3 3 3 3 3 16 16 16 16 3 3 3 3 3 3 1 1 16 1 25 26 29 18 17 17 17 17 17 17 17 17 20 21 31 18 18 18 18 18 18 18 18 24 2 16 16 16 16 8 3 3 7 25 26 26 29 18 18 17 17 17 17 18 18 18 18 28 27 17 17 16 16 1 2 16 16 16 16 1 1 2 16 16 16 2 16 16
16 3 3 3 3 3 3 3 3 3 3 3 3 3 3 3 16 16 1 16 16 2 2 2 3 3 3 1 1 16 1 1 1 3 25 17 17 17 17 17 17 17 17 17 23 18 18 18 18 18 18 18 18 18 18 24 2 16 16 16 16 8 3 3 9 10 10 13 23 18 18 17 17 17 17 18 18 18 18 24 17 17 17 16 16 1 2 16 16 16 16 16 16 2 1 16 16 16 2 16
16 16 1 3 16 16 1 1 16 16 16 3 3 3 1 1 1 16 1 16 16 2 16 16 16 3 3 1 1 16 16 1 33 3 17 17 17 17 17 17 17 17 20 21 31 18 18 18 18 18 18 18 18 18 18 24 2 16 16 16 16 8 3 3 3 3 3 7 23 18 18 18 18 18 18 18 18 19 18 24 17 17 17 16 16 1 2 16 16 16 16 16 16 2 1 1 16 16 2 16
16 16 1 3 16 1 1 16 16 16 1 3 3 1 1 1 1 16 1 1 16 2 16 16 16 3 1 1 16 16 1 1 33 8 3 3 17 17 17 17 17 20 18 18 18 18 18 18 18 18 18 18 18 18 18 24 2 16 16 16 16 8 3 3 3 3 3 7 25 26 26 29 18 18 18 18 18 18 18 24 17 17 17 16 1 1 2 16 16 16 16 16 16 2 16 1 16 16 2 16
16 16 1 3 1 1 16 1 1 1 1 3 3 1 1 16 1 16 1 2 16 2 16 16 16 3 1 1 16 1 1 16 33 11 3 3 3 17 17 17 17 23 18 18 18 18 18 18 18 18 18 18 18 18 18 24 2 16 16 16 16 8 3 3 3 3 3 3 3 3 7 25 18 18 18 18 18 18 18 24 17 17 17 16 1 1 2 16 16 16 16 16 16 2 16 1 16 16 16 16
16 16 1 3 16 16 33 16 16 16 1 3 3 1 1 16 1 1 1 1 1 1 1 1 3 3 1 1 16 33 16 16 11 3 3 3 3 3 7 17 20 31 18 18 18 18 18 18 18 18 18 18 18 18 18 18 21 22 16 16 16 8 3 3 3 3 3 3 3 3 3 3 23 18 18 18 19 18 18 24 17 17 17 1 1 1 2 16 16 16 16 16 16 2 16 1 1 16 16 16
16 3 3 3 3 3 1 16 16 16 1 3 3 3 1 1 1 1 1 2 16 2 16 1 3 1 33 1 16 33 16 8 3 3 3 3 3 3 7 16 23 18 18 18 18 18 18 18 18 18 18 18 18 18 18 18 18 30 22 16 16 14 5 6 3 3 3 3 3 3 3 3 25 26 26 26 26 26 26 27 17 17 17 1 1 16 2 16 16 16 16 16 16 2 16 16 1 16 16 16
16 3 3 3 3 3 3 3 3 3 3 3 3 3 16 16 3 3 3 3 3 3 16 3 3 16 1 1 16 16 16 11 3 3 3 3 3 4 15 16 23 18 18 18 18 18 18 18 18 18 18 18 18 18 18 18 18 18 30 22 16 16 1 14 5 5 5 6 3 3 3 3 3 3 3 3 3 3 3 3 17 17 1 1 1 2 2 16 16 16 16 16 16 2 2 2 2 2 2 16
16 1 1 1 1 3 3 3 1 1 1 1 1 3 3 3 3 3 3 3 3 3 3 3 3 3 3 3 3 16 16 3 3 3 3 3 4 15 16 16 23 18 18 18 18 18 18 18 18 18 18 18 28 26 26 29 18 18 18 24 16 16 17 17 17 16 16 14 5 5 5 5 6 3 3 3 3 3 3 3 17 17 1 1 16 2 16 16 16 16 16 16 16 16 16 16 1 16 1 16
16 1 16 16 1 3 3 1 1 33 1 1 1 1 3 3 3 16 1 16 16 3 3 3 3 3 3 3 3 3 3 3 3 3 4 5 15 16 16 16 23 18 18 18 18 18 18 18 18 18 28 26 27 2 2 25 29 18 18 30 22 17 17 17 16 16 16 16 16 16 16 16 14 5 5 5 5 5 5 5 5 1 1 2 2 2 16 16 16 1 1 1 1 16 16 16 1 16 1 16
16 16 16 33 1 3 16 1 16 16 16 16 1 1 3 3 16 16 1 33 16 33 3 3 16 1 1 1 3 3 3 3 3 3 7 16 16 16 16 1 23 18 18 18 18 18 18 18 18 18 24 2 2 16 17 17 23 28 26 26 27 17 2 2 1 1 1 1 16 16 16 16 16 16 16 16 16 16 16 16 1 1 2 2 16 16 16 16 1 1 16 16 1 16 16 16 1 16 1 16
16 1 16 16 1 3 16 1 33 1 1 1 16 16 3 1 1 1 1 1 1 33 3 3 3 16 1 1 33 3 3 3 3 4 15 16 16 16 1 1 23 18 18 18 18 18 18 18 18 18 24 2 17 3 3 17 25 27 2 17 17 2 20 22 16 16 16 1 16 16 16 16 16 16 16 16 16 16 1 1 1 2 2 16 16 16 20 22 16 16 16 16 16 16 16 16 1 16 1 16
16 16 16 33 33 3 16 1 16 1 1 16 16 3 3 1 1 16 1 33 1 1 3 3 3 16 1 1 33 8 3 3 3 7 16 16 1 1 1 1 23 18 18 18 18 18 18 18 18 18 24 2 16 16 3 3 3 16 16 16 16 16 23 30 21 22 2 16 1 1 16 16 1 1 16 16 16 16 1 16 16 2 16 20 21 21 28 27 16 16 16 16 16 16 16 16 1 16 1 16
16 10 10 10 13 3 33 1 33 1 1 1 1 3 3 1 16 1 1 16 16 1 3 3 3 1 1 1 12 11 3 3 3 7 16 1 1 16 1 16 25 29 18 18 18 18 18 18 18 18 24 2 17 16 16 17 3 17 3 3 17 16 23 18 18 30 21 21 22 1 1 1 1 1 1 16 16 16 16 16 20 21 21 31 18 28 27 16 16 16 16 16 16 16 16 16 1 1 1 16
16 3 3 3 9 3 10 1 1 1 33 33 3 3 3 16 16 16 1 1 16 1 3 3 3 1 1 16 8 3 3 3 4 15 1 1 16 16 16 1 1 25 29 18 18 18 18 18 18 18 24 2 17 17 16 16 3 3 16 3 16 16 23 18 18 18 18 18 30 21 21 21 21 21 21 21 21 21 21 21 31 18 18 18 18 24 16 16 16 3 3 3 16 16 16 16 16 1 16 16
16 3 3 3 3 3 3 9 10 10 10 10 3 3 16 33 33 1 33 1 1 1 3 3 3 1 16 16 8 3 3 3 7 1 1 1 16 16 16 1 1 1 23 18 18 18 18 18 18 18 24 2 2 17 16 3 16 16 16 17 3 16 25 26 26 18 18 18 18 18 18 18 18 18 18 18 18 18 18 18 18 18 18 26 29 24 16 16 3 3 35 3 3 3 16 16 16 1 16 16
16 3 3 3 3 3 3 3 3 3 3 3 3 10 10 10 10 10 13 33 1 1 3 3 3 1 33 12 11 3 3 3 7 1 1 16 16 16 16 16 1 1 25 29 18 18 18 18 18 18 30 22 2 2 16 16 16 16 16 16 16 3 2 2 2 25 26 26 29 18 18 18 18 18 18 18 18 18 18 18 18 18 24 2 25 27 3 3 3 3 3 3 3 3 3 16 16 1 1 16
16 16 16 16 16 3 3 3 3 3 3 3 3 3 3 3 3 3 9 10 10 10 3 3 10 10 10 11 3 3 3 4 15 1 16 1 1 1 1 1 1 1 1 25 29 18 18 18 18 18 18 30 22 2 2 17 3 3 3 16 16 16 3 17 2 2 2 2 23 18 18 18 18 18 18 18 18 18 18 18 18 26 27 16 16 16 3 3 3 3 3 3 3 3 3 16 16 1 1 16
16 16 16 16 16 16 16 16 3 3 3 3 3 3 3 3 3 3 3 3 3 3 3 3 3 3 3 3 3 3 3 7 16 1 1 1 16 16 1 1 1 1 1 16 25 26 29 18 18 18 18 18 30 22 2 2 3 3 17 16 3 3 17 16 16 16 16 2 23 18 18 18 18 18 18 18 18 18 18 28 27 1 16 16 16 16 3 3 3 3 3 3 3 3 3 16 16 1 1 16
16 16 16 16 16 16 16 16 16 16 16 16 16 16 16 3 1 1 3 3 3 3 3 3 3 3 3 3 3 3 3 9 10 10 16 16 16 16 16 16 16 16 16 16 16 16 25 26 29 18 18 18 18 30 22 2 3 3 17 16 16 3 3 16 3 2 2 20 31 18 18 18 18 18 18 18 28 26 26 27 16 16 16 16 16 16 3 3 3 3 3 3 3 3 3 16 16 1 16 16
16 16 16 16 16 16 16 16 16 16 16 16 16 16 16 16 16 1 1 3 3 3 3 3 3 16 16 16 3 3 3 3 3 3 3 3 3 16 16 16 16 16 16 16 16 16 16 16 25 26 29 18 18 18 30 21 22 2 2 2 16 2 2 2 2 20 21 31 18 18 18 18 18 18 18 28 27 16 16 16 16 16 16 16 16 3 3 3 3 3 3 3 3 3 3 16 16 1 16 16
16 16 16 1 1 1 1 1 1 1 1 1 1 1 1 16 16 16 1 1 1 16 16 16 16 16 16 16 3 3 1 1 1 1 3 3 3 3 3 3 3 3 16 16 16 16 16 16 16 16 25 26 26 29 18 18 30 21 21 21 21 21 21 21 21 31 18 18 18 18 18 18 18 18 18 24 1 16 16 16 16 16 3 3 3 3 3 3 3 3 3 3 3 3 16 16 16 1 1 16
16 16 16 1 1 1 1 1 1 1 1 1 1 1 1 1 16 16 16 16 16 1 1 1 1 16 16 16 3 3 1 1 1 2 1 1 2 3 3 3 3 3 3 3 3 3 16 16 16 16 16 16 16 25 26 26 26 26 26 26 26 26 26 26 29 18 18 18 18 18 18 18 28 26 26 27 2 16 16 16 16 3 3 3 3 3 3 3 3 3 3 3 3 16 16 16 16 16 1 16
16 16 1 1 1 1 16 16 16 16 16 1 1 16 16 1 1 1 1 1 1 1 16 16 1 16 16 16 3 3 2 1 1 1 1 1 1 1 1 2 1 3 3 3 3 3 3 3 3 16 16 16 16 16 16 16 16 16 16 16 16 16 2 2 25 26 26 26 26 26 26 26 27 1 1 16 16 16 16 16 3 3 3 3 3 3 3 16 16 16 16 16 16 16 16 16 16 16 1 16
16 16 1 1 1 16 16 16 16 16 16 16 16 16 16 16 16 16 16 16 16 1 1 1 16 16 16 3 3 1 1 1 2 1 1 1 1 1 1 1 1 2 1 1 1 3 3 3 3 3 3 3 16 16 16 16 16 16 16 16 16 16 16 16 16 16 1 1 16 1 1 16 1 16 1 16 16 3 3 3 3 3 3 3 3 16 16 16 16 16 16 16 16 16 16 16 16 1 1 16
16 1 1 1 16 16 16 16 16 16 16 16 16 16 16 16 16 16 16 16 16 16 16 16 16 16 16 3 3 1 2 1 1 2 1 1 2 1 1 1 2 1 1 1 1 1 2 2 3 3 3 3 3 3 3 16 16 16 16 16 16 16 16 16 16 16 16 16 1 1 16 16 1 16 1 3 3 3 3 3 3 3 16 16 16 16 16 16 16 16 16 16 16 16 16 16 16 1 16 16
16 1 1 1 16 20 21 21 21 21 21 21 21 22 16 16 16 16 16 16 16 16 16 16 16 16 16 3 32 32 32 32 32 32 32 32 1 1 1 1 1 1 1 1 2 1 1 1 1 1 1 2 3 3 3 3 3 3 3 16 16 16 16 16 1 1 1 1 1 16 16 1 3 3 3 3 3 3 16 16 16 16 16 16 16 16 16 16 16 16 16 16 16 16 1 1 1 1 16 16
16 1 1 16 16 23 16 16 16 16 18 18 16 30 21 21 21 21 21 21 21 21 22 16 16 16 3 3 32 34 34 34 34 34 34 32 2 1 1 1 1 1 1 1 1 1 1 1 1 2 1 1 2 1 2 3 3 3 3 3 3 3 3 16 16 1 1 1 16 1 1 3 3 3 3 3 16 16 16 16 16 16 16 16 16 1 1 1 1 16 16 1 1 1 1 16 16 16 16 16
16 1 16 16 16 23 16 16 19 16 16 18 16 16 1 1 16 16 16 16 16 16 24 16 16 16 3 3 32 34 34 34 34 34 34 32 1 1 1 1 1 1 1 1 1 1 1 1 1 1 2 1 1 1 1 1 1 1 1 3 3 3 3 3 3 3 1 1 1 3 3 3 3 3 3 16 16 16 16 16 16 16 16 16 16 1 16 16 1 1 1 1 16 16 16 16 16 16 16 16
16 16 16 16 16 23 16 16 16 16 16 18 16 16 16 1 16 16 16 16 16 16 24 16 16 16 3 3 32 34 34 34 34 34 34 32 32 32 32 32 32 32 32 32 2 1 1 1 1 1 1 1 1 1 20 21 21 21 22 2 1 2 2 3 3 3 3 3 3 3 3 3 16 16 16 16 16 16 16 16 16 16 16 16 16 16 1 1 16 16 16 16 16 16 16 16 16 16 16 16
16 16 16 16 16 23 16 16 16 16 18 18 16 16 16 1 16 16 16 16 16 16 24 16 16 3 3 2 32 34 34 34 34 34 34 34 34 34 34 34 34 34 34 32 16 16 1 1 1 1 1 1 1 1 23 18 18 18 24 2 1 1 1 1 1 1 3 3 3 3 3 3 3 3 3 16 16 16 16 16 16 16 16 16 16 16 16 1 1 16 16 16 16 16 16 16 16 16 16 16
16 16 20 21 21 31 16 16 16 16 18 16 16 16 16 1 16 16 16 19 16 16 24 16 16 3 3 2 32 34 34 34 34 34 34 34 34 34 34 34 34 34 34 32 16 16 1 1 1 1 1 1 1 2 23 18 18 18 30 21 21 21 21 21 21 21 22 2 3 3 3 3 3 3 3 3 16 16 16 16 16 16 16 16 16 16 16 16 1 1 1 16 16 16 16 16 16 16 16 16
16 16 23 16 16 16 16 16 16 18 18 16 16 16 1 1 16 16 28 26 26 26 27 16 16 3 3 2 32 34 34 34 34 34 34 34 32 32 32 32 32 32 32 32 16 16 2 1 1 1 1 1 1 1 23 18 18 18 18 18 18 18 18 18 18 18 30 21 21 21 21 22 3 3 3 3 3 3 3 3 3 3 3 3 3 3 16 16 16 16 1 1 16 16 16 16 16 16 16 16
16 16 23 16 16 19 16 16 18 18 16 16 16 16 1 16 16 16 24 16 16 16 16 8 3 3 7 2 32 34 34 34 34 34 34 34 32 1 16 1 1 16 16 16 16 16 16 16 16 1 16 16 1 1 25 29 18 18 18 18 18 18 18 18 18 18 18 18 18 18 18 30 22 3 3 3 3 3 3 3 3 3 3 3 3 3 3 3 3 16 16 16 1 1 16 16 16 16 16 16
16 16 23 16 16 16 16 18 18 18 18 18 16 1 16 16 16 16 24 16 16 16 16 8 3 3 7 32 32 34 34 34 34 34 34 34 32 2 16 16 1 16 16 16 16 16 16 16 16 1 16 16 16 16 16 25 29 18 18 19 18 18 18 18 18 18 18 18 18 18 18 18 24 3 3 16 16 16 16 16 16 16 16 3 3 1 3 3 3 3 3 16 16 1 1 16 16 16 16 16
16 16 23 16 16 16 16 18 16 16 16 18 18 1 16 16 16 16 24 16 16 16 1 1 3 3 34 34 34 34 34 34 34 34 34 34 32 2 16 16 1 16 16 16 16 16 16 16 16 1 1 16 16 16 16 16 25 29 18 18 18 18 18 18 19 18 18 18 18 18 18 18 24 3 3 16 16 16 16 16 16 16 16 16 1 1 16 3 3 3 3 3 3 16 1 1 16 16 16 16
16 16 23 16 16 1 1 1 1 1 16 16 16 1 1 18 18 16 24 16 16 16 1 8 3 3 34 34 34 34 34 34 34 34 34 34 32 2 16 16 1 1 16 16 16 16 16 16 16 16 1 16 16 16 16 16 16 25 29 18 18 18 18 18 18 18 18 18 18 28 26 26 27 3 3 16 16 16 16 16 16 16 16 16 1 1 16 16 16 3 3 3 3 3 1 1 1 16 16 16
16 16 25 29 16 16 16 18 16 16 16 16 1 1 1 16 16 16 24 16 16 1 1 8 3 3 1 32 32 32 32 32 32 32 32 32 32 2 16 16 16 1 1 1 1 16 16 16 16 16 1 1 16 16 16 16 16 16 25 29 18 18 18 18 18 18 19 18 18 24 16 16 8 3 3 16 16 16 16 16 16 16 16 16 1 1 16 16 16 16 3 3 3 3 1 1 1 1 16 16
16 16 16 23 16 16 18 18 18 16 16 16 16 1 1 1 1 1 1 1 1 1 16 8 3 3 7 2 1 1 2 1 1 1 2 1 1 16 16 16 16 16 16 16 1 1 16 16 16 16 16 2 1 16 16 16 16 16 16 25 26 29 18 18 18 18 18 18 18 24 16 16 8 3 3 16 16 16 16 16 16 16 16 16 1 1 16 16 16 16 16 16 3 3 3 1 1 1 16 16
16 16 16 23 16 16 18 16 18 18 18 16 16 16 16 16 1 1 1 1 1 16 16 8 3 3 7 1 1 1 1 1 1 1 1 1 2 16 16 16 16 16 16 16 16 1 16 16 16 16 1 1 2 1 2 16 16 16 16 16 16 25 26 26 29 18 18 18 18 24 16 16 8 3 3 16 16 16 16 16 16 16 16 1 1 1 1 16 16 16 16 16 16 3 3 3 3 16 16 16
16 16 16 23 16 16 18 18 16 16 18 18 16 16 16 16 16 16 24 16 16 16 16 8 3 3 7 1 1 2 1 1 1 1 1 2 16 16 16 16 16 16 16 16 16 16 1 1 1 1 1 1 1 2 1 1 1 16 16 16 16 16 16 16 23 18 18 18 18 24 16 16 8 3 3 16 16 16 16 16 16 16 16 1 16 1 16 1 16 16 16 16 16 16 3 3 3 3 16 16
16 16 16 23 16 16 16 18 18 16 16 18 18 19 16 16 16 16 24 16 16 16 16 8 3 1 1 1 1 1 1 1 1 1 1 2 16 16 16 16 16 16 16 16 16 16 16 16 16 1 1 16 16 1 16 2 1 1 16 16 16 16 16 16 23 18 18 18 19 24 16 16 8 3 3 16 16 16 16 16 16 16 1 1 16 16 16 1 1 16 16 16 16 16 16 3 3 3 3 16
16 1 16 25 26 29 16 16 18 18 18 18 18 16 16 16 16 16 24 16 16 16 16 8 1 1 7 2 1 1 1 1 2 1 1 16 16 16 16 16 16 16 16 16 16 16 16 16 16 16 16 1 1 1 16 16 2 1 1 16 16 16 16 16 23 18 18 18 28 27 16 16 8 3 3 16 16 16 16 16 16 16 1 16 16 16 16 16 1 1 16 16 16 16 16 16 3 3 3 16
16 1 16 16 16 25 26 29 16 16 18 18 16 16 16 19 16 16 24 16 16 16 1 1 3 3 7 1 1 1 1 1 1 1 1 16 32 32 32 32 32 32 32 32 32 32 16 16 16 1 1 1 16 16 16 16 16 16 2 1 1 16 16 16 23 18 18 18 24 16 16 16 8 3 3 16 16 16 16 16 16 16 1 1 16 16 1 1 1 1 16 16 16 16 16 16 16 3 3 16
16 1 1 16 16 16 16 25 29 16 29 16 16 16 16 16 16 16 24 16 16 1 1 8 3 3 7 1 1 1 1 2 1 1 1 16 32 34 34 34 34 34 34 34 34 32 16 16 1 1 16 16 16 16 16 16 16 16 16 16 1 1 16 16 23 18 18 18 30 21 22 16 8 3 3 16 16 16 16 16 16 1 1 1 1 1 1 16 1 1 16 16 16 16 16 16 16 16 3 16
16 16 1 1 16 16 16 16 25 26 26 26 26 26 26 26 26 26 27 16 16 1 16 8 3 3 7 2 1 1 1 1 1 1 2 16 32 34 34 34 34 34 34 34 34 32 16 16 1 16 16 16 16 16 16 16 16 16 16 16 16 1 2 16 23 18 18 18 18 18 24 16 8 3 3 16 16 16 16 16 16 16 1 1 16 16 16 16 1 1 16 16 16 16 16 16 16 16 16 16
16 16 16 1 1 16 16 16 16 16 16 16 16 16 16 16 16 16 16 16 16 16 16 8 3 3 7 2 1 1 1 1 1 1 1 16 32 34 34 34 34 34 34 34 34 32 16 16 1 16 16 16 16 16 16 16 16 16 16 16 16 1 1 16 23 18 18 18 18 18 24 16 8 3 3 16 16 16 16 16 16 16 1 1 16 16 16 16 1 1 16 16 16 16 16 16 16 16 16 16
16 10 10 10 1 1 10 10 10 10 10 10 10 10 10 10 10 10 10 10 10 10 10 11 3 3 9 10 10 10 10 10 10 10 10 16 32 34 34 34 34 34 34 34 34 32 16 16 1 16 16 3 3 3 3 3 3 3 3 16 16 16 2 16 23 19 18 18 18 19 24 16 8 3 3 16 16 16 16 16 16 16 1 1 16 16 16 16 1 1 16 16 16 16 16 16 16 16 16 16
16 3 3 3 3 3 3 3 3 3 3 3 3 3 3 3 3 3 3 3 3 3 3 3 3 3 3 3 3 3 3 3 3 3 3 3 3 34 34 34 34 34 34 34 34 32 16 16 1 16 3 3 3 3 3 3 3 3 3 16 16 16 1 16 23 18 18 18 18 18 24 16 8 3 3 16 16 16 16 16 16 16 1 1 16 16 16 16 1 16 16 16 16 16 16 16 16 16 16 16
16 3 3 3 3 3 3 3 3 3 3 3 3 3 3 3 3 3 3 3 3 3 3 3 3 3 3 3 3 3 3 3 3 3 3 3 3 34 34 34 34 34 34 34 34 32 16 16 1 16 3 3 3 3 3 3 3 3 3 16 16 1 1 16 23 18 18 18 18 18 24 16 8 3 3 16 16 16 16 16 16 16 1 1 16 16 16 16 1 16 16 16 16 16 16 16 16 16 1 16
16 5 5 5 5 5 5 3 5 5 5 5 5 5 5 5 3 3 5 5 5 5 5 6 3 3 7 16 16 16 1 1 1 16 16 16 32 34 34 34 34 34 34 34 34 32 16 16 1 16 3 3 3 3 3 3 3 3 3 16 1 1 16 16 23 18 18 18 18 18 24 16 8 3 3 16 16 16 1 16 16 16 1 1 16 16 16 16 1 1 16 16 16 16 16 16 16 1 1 16
16 16 16 16 16 33 3 3 2 1 1 33 33 16 16 16 16 16 2 16 16 33 33 8 3 3 7 16 16 16 1 1 1 16 16 16 32 34 34 34 34 34 34 34 34 32 16 16 1 16 3 3 3 3 3 3 3 3 16 1 1 16 16 16 23 18 18 18 18 18 24 16 8 3 3 16 16 16 16 1 1 16 1 1 16 16 16 16 1 1 1 16 16 16 16 16 16 1 16 16
16 16 16 16 16 3 3 33 2 1 1 2 16 16 33 3 3 16 1 1 16 16 33 8 3 3 7 16 16 2 2 16 16 16 16 16 32 34 34 34 34 34 34 34 34 32 16 16 16 16 3 3 3 3 3 16 16 16 16 1 16 16 16 16 23 18 19 18 18 18 24 16 8 3 3 16 16 16 16 16 1 1 1 1 16 16 16 16 16 1 1 1 16 16 16 16 1 16 16 16
16 16 16 33 33 3 16 16 16 33 1 1 1 16 16 1 1 1 1 1 16 16 16 8 3 3 7 16 16 1 16 16 16 16 16 16 32 34 34 34 34 34 34 34 34 32 16 16 16 16 3 3 3 3 16 16 16 16 2 2 16 16 16 20 31 18 18 18 18 18 24 16 8 3 3 16 16 16 16 1 1 1 1 16 16 16 16 16 16 16 1 1 1 1 16 1 16 16 16 16
16 33 16 16 16 3 3 3 3 3 3 3 1 3 3 1 16 16 16 1 16 16 16 8 3 3 7 16 16 1 16 16 2 16 16 16 32 32 32 32 32 32 32 32 32 32 16 16 16 3 3 3 3 16 16 16 2 1 2 16 16 16 16 18 18 18 18 18 18 28 27 16 8 3 3 16 16 16 16 1 1 16 16 16 16 16 16 16 16 16 16 16 1 1 1 16 16 16 16 16
16 33 16 16 16 3 16 16 16 16 16 16 16 16 3 3 3 3 16 2 16 16 16 8 3 3 7 16 16 1 1 1 1 1 1 2 16 16 16 16 16 16 16 16 16 16 16 16 3 3 3 3 16 16 16 1 1 16 16 16 16 20 21 18 18 18 18 18 18 24 16 16 8 3 3 16 16 16 1 1 16 16 16 16 16 16 16 16 16 16 16 16 16 1 1 16 16 16 16 16
16 16 16 16 3 3 16 16 2 1 33 2 16 16 16 16 3 1 1 1 1 3 3 3 3 3 7 16 16 1 2 16 16 1 1 1 1 16 16 16 16 16 16 16 16 16 16 16 3 3 3 16 16 16 1 1 16 16 16 16 16 23 18 18 18 18 18 18 18 24 16 16 8 3 3 16 16 1 1 16 16 16 16 16 16 16 16 16 16 16 16 16 16 1 1 16 16 16 16 1
16 16 16 16 3 1 1 2 1 2 16 16 16 16 16 3 3 3 3 1 1 16 33 8 3 3 7 1 16 1 1 16 16 16 1 2 1 1 16 16 16 16 16 16 16 16 16 2 2 3 3 16 16 1 1 16 16 20 21 21 21 31 18 18 19 18 18 18 18 24 16 16 8 3 3 1 1 1 1 1 16 16 16 16 16 16 1 1 16 16 16 16 16 16 1 16 1 1 1 16
16 3 16 16 3 1 1 1 1 1 16 3 3 3 3 3 3 3 3 3 3 33 3 3 3 3 7 2 1 1 1 16 16 16 16 16 2 1 1 2 1 1 1 1 1 1 1 1 2 3 16 16 16 1 16 16 20 31 19 18 18 18 18 18 18 18 18 18 18 24 16 16 8 3 3 16 16 16 16 1 1 16 16 16 1 1 1 1 1 16 16 16 16 16 1 1 16 16 16 16
16 3 16 16 16 3 16 16 1 1 16 3 3 3 16 3 3 3 1 1 3 33 3 8 3 3 7 16 16 2 1 2 16 16 16 16 16 16 1 2 1 16 16 16 16 16 16 1 1 3 16 16 2 1 16 20 31 18 18 18 18 19 18 18 18 18 18 18 18 24 16 16 8 3 3 16 16 16 1 1 1 1 1 1 1 1 1 1 1 1 1 16 1 1 1 16 16 16 16 16
16 3 3 33 16 3 16 2 16 16 3 3 16 16 3 3 3 3 1 2 2 16 16 8 3 3 7 16 16 16 16 1 16 16 16 16 16 2 1 16 1 16 16 16 16 16 2 1 3 3 16 16 1 2 20 31 18 18 18 18 18 18 18 28 26 26 26 26 26 27 16 16 8 3 3 16 16 16 1 16 16 1 1 1 1 16 16 16 1 1 1 1 1 1 16 16 16 16 16 16
16 16 3 33 16 3 16 16 16 3 16 16 16 16 3 1 3 3 2 33 3 16 16 8 3 3 7 16 16 16 16 1 16 16 16 2 1 1 16 16 1 1 16 16 16 2 1 16 3 3 2 1 1 1 23 19 18 18 18 18 18 18 19 24 16 16 16 16 16 16 16 16 16 3 3 16 16 16 16 16 16 16 1 1 16 16 16 16 16 1 1 1 1 16 16 16 16 16 16 16
16 16 16 3 16 3 33 16 3 3 2 16 16 3 3 1 1 2 16 3 3 16 33 8 3 3 7 16 16 16 16 1 16 1 1 16 16 16 16 16 16 1 16 1 1 2 16 16 3 3 1 1 1 1 23 18 18 18 18 18 18 28 26 27 2 2 2 2 2 2 2 2 2 3 3 16 16 16 16 16 16 16 16 1 16 16 16 16 16 16 16 16 1 1 16 16 16 16 16 16
16 16 16 3 3 3 33 16 3 16 1 16 16 3 3 3 16 3 1 3 3 16 16 8 3 3 7 16 16 1 1 1 16 1 2 16 16 16 16 16 16 2 1 1 16 16 16 16 3 3 2 1 1 1 23 18 18 18 18 18 18 24 2 2 2 3 3 3 3 3 3 3 3 3 3 3 3 16 16 16 16 16 16 16 1 16 16 16 16 16 16 16 16 1 1 16 16 16 16 16
16 16 16 16 3 16 16 16 3 16 1 16 3 3 16 2 1 3 2 1 3 3 3 8 3 3 7 2 16 1 16 2 1 1 1 1 1 16 16 1 1 1 1 16 16 16 16 16 3 3 2 1 1 1 25 26 26 26 26 26 26 27 3 3 3 3 3 3 3 3 3 3 3 3 3 3 3 3 3 16 16 16 16 16 1 1 16 16 16 16 16 16 16 16 1 16 16 16 16 16
16 1 16 16 3 16 16 3 16 16 1 16 3 3 16 1 1 1 3 16 2 16 16 8 3 3 7 1 16 1 16 1 1 16 2 1 1 1 2 1 1 16 16 16 16 16 16 16 3 3 1 2 1 1 1 1 2 2 3 3 3 3 3 3 3 3 16 16 16 16 16 16 16 16 16 16 3 3 3 3 16 16 16 16 16 16 16 16 16 16 16 16 16 16 16 16 16 16 16 16
16 1 2 16 3 16 16 3 16 16 16 2 3 3 16 16 3 3 3 16 2 2 16 8 3 3 7 1 16 1 16 1 1 16 16 1 16 16 16 16 16 2 16 16 16 16 16 16 3 3 2 1 2 3 3 3 3 3 3 3 3 3 16 16 16 16 16 2 2 16 16 16 16 16 16 16 16 16 3 3 3 16 16 16 16 16 16 16 16 16 16 16 16 16 16 16 16 16 16 16
16 1 1 16 3 16 3 3 16 33 16 2 16 3 3 3 3 16 3 3 16 2 16 8 3 3 7 1 16 16 16 1 1 16 16 1 1 16 16 1 1 2 16 16 16 16 16 16 3 3 3 3 3 3 3 3 3 3 16 16 16 16 16 16 16 16 16 2 16 16 16 16 16 16 16 16 16 16 16 16 3 3 3 16 16 16 16 16 16 16 16 16 16 16 16 16 16 16 16 16
16 3 3 3 3 16 3 16 3 3 16 16 16 3 3 3 33 16 16 3 33 3 3 3 3 3 7 1 16 16 16 1 2 16 16 2 1 16 1 1 1 16 16 16 16 16 16 16 3 3 3 3 3 3 16 16 16 16 16 16 16 16 16 16 16 16 16 16 16 16 16 16 16 16 2 2 2 2 16 16 16 3 3 3 3 16 16 16 16 16 16 16 16 16 16 16 16 16 16 16
16 16 16 3 3 16 3 3 16 16 16 3 3 3 3 16 3 3 2 16 16 3 16 8 3 3 7 1 16 16 16 1 2 16 16 2 1 16 1 1 16 16 16 16 16 3 3 3 3 3 3 3 16 16 16 16 16 16 16 16 16 16 16 16 16 16 16 16 16 16 16 16 16 2 2 16 16 2 2 16 16 16 16 3 3 3 16 16 16 16 16 16 16 16 16 16 16 16 16 16
16 16 16 16 3 33 16 3 3 3 3 3 2 16 3 16 33 1 1 16 33 16 1 8 3 3 7 2 16 16 16 2 1 1 16 16 16 1 1 16 16 16 16 3 3 3 3 3 16 16 16 16 16 16 16 16 16 16 2 16 16 16 16 16 16 2 2 16 16 16 16 16 16 16 2 16 16 16 2 16 16 16 16 16 3 3 3 3 16 16 16 16 16 16 16 16 16 16 16 16
16 16 2 16 3 3 3 3 3 16 16 16 1 1 3 3 16 16 1 16 16 2 1 8 3 3 7 1 16 16 1 1 16 1 16 16 1 1 16 16 16 16 3 3 3 3 16 16 16 16 16 2 16 16 16 16 16 16 16 16 16 16 16 16 2 2 2 16 16 16 16 16 16 16 2 16 16 16 2 16 16 16 16 16 16 16 3 3 3 3 16 16 16 16 16 16 16 16 16 16
16 2 1 2 16 3 3 3 3 16 33 16 1 1 16 3 16 16 1 1 16 1 16 8 3 3 7 1 16 1 1 16 16 16 16 2 1 16 16 16 3 3 3 3 16 16 16 16 16 16 2 2 2 16 16 16 16 16 2 16 16 16 16 16 2 16 16 2 16 16 16 16 16 16 2 2 2 2 2 16 16 16 16 16 16 16 16 16 3 3 3 16 16 16 16 16 16 16 16 16
33 16 1 1 16 16 3 16 3 16 16 2 1 2 16 3 3 16 16 1 2 1 16 8 3 3 7 2 2 2 16 16 16 16 2 2 16 16 3 3 3 3 16 16 16 16 16 16 16 16 2 16 16 16 16 16 16 16 2 16 16 16 16 16 2 16 16 2 2 16 16 16 16 2 16 16 16 16 16 16 16 16 16 16 16 16 16 16 16 3 3 3 16 16 16 16 16 16 16 16
16 16 1 1 16 16 16 3 3 3 16 2 1 16 16 16 1 1 1 1 1 2 16 8 3 3 7 16 2 16 16 16 16 16 16 16 3 3 3 3 3 16 16 16 16 16 16 16 16 16 2 16 16 2 2 2 2 16 2 16 16 16 16 2 2 2 2 2 2 16 16 16 16 2 16 16 16 16 16 16 16 16 16 16 16 16 16 16 16 16 16 3 3 3 16 16 16 16 16 16
16 16 1 1 16 16 16 3 3 3 3 16 33 16 2 16 16 3 16 2 1 16 16 8 3 3 9 10 10 10 10 10 10 10 3 3 3 3 3 16 16 16 16 16 16 16 16 16 16 16 2 2 16 16 2 16 16 16 2 16 16 16 16 2 16 16 16 16 2 2 16 16 16 2 16 16 16 16 16 16 16 16 16 16 16 16 16 16 16 16 16 16 3 3 3 16 16 16 16 16
16 1 2 1 16 16 16 16 3 3 3 3 16 2 1 16 16 3 3 16 16 16 16 8 3 3 3 3 3 3 3 3 3 3 3 3 3 3 16 16 16 16 16 16 16 16 16 16 16 16 16 2 2 2 16 16 16 16 2 16 16 16 16 2 16 16 16 16 16 2 16 16 16 16 16 16 16 16 16 16 16 16 16 16 16 16 16 16 16 16 16 16 16 16 3 3 3 16 16 16
16 16 16 16 16 16 16 16 16 16 16 16 16 16 16 16 16 16 16 16 16 16 16 16 16 16 16 16 16 16 16 16 16 16 16 16 16 16 16 16 16 16 16 16 16 16 16 16 16 16 16 16 16 16 16 16 16 16 16 16 16 16 16 16 16 16 16 16 16 16 16 16 16 16 16 16 16 16 16 16 16 16 16 16 16 16 16 16 16 16 16 16 16 16 16 16 16 16 16 16