16 16 16 16 16 16 16 16 16 16 16 16 16 16 16 16 16 16 16 16 16 16 16 16 16 16 16 16 16 16 16 16 16 16 16 16 16 16 16 16 16 16 16 16 16 16 16 16 16 16 16 16 16 16 16 16 16 16 16 16 16 16 16 16 16 16 16 16 16 16 16 16 16 16 16 16 16 16 16 16 16 16 16 16 16 16 16 16 16 16 16 16 16 16 16 16 16 16 16 16
16 16 16 16 16 16 16 16 16 16 16 16 16 16 16 16 16 16 16 16 16 16 16 16 16 16 16 16 16 16 16 16 16 16 16 16 16 16 16 16 16 16 16 16 16 16 16 16 16 16 16 16 16 16 16 16 16 16 16 16 16 16 16 16 16 16 16 16 16 16 16 16 16 16 16 16 16 16 16 16 16 16 16 16 16 16 16 16 16 16 16 16 16 16 16 16 16 16 16 16
16 16 16 16 16 16 16 16 16 16 16 16 16 16 16 16 16 16 1 1 1 1 1 1 1 16 16 16 16 16 16 16 16 1 1 1 16 16 16 16 16 16 16 16 16 16 16 16 16 16 16 16 16 16 16 16 16 16 16 16 16 16 16 16 16 16 16 16 16 16 16 16 16 16 16 16 16 16 16 16 16 16 16 16 16 16 16 16 16 16 16 16 16 16 16 16 16 16 16 16
16 16 16 16 16 16 16 16 16 16 16 16 16 16 1 1 1 1 1 16 16 1 1 1 1 1 1 1 16 16 1 1 1 16 16 1 1 1 1 16 16 16 16 16 16 16 16 16 16 16 16 16 16 16 16 16 16 16 16 16 16 1 1 1 1 1 1 1 1 1 1 1 1 1 1 1 1 1 1 1 1 1 16 16 16 16 16 16 16 16 16 16 16 16 16 16 16 16 16 16
16 16 16 16 16 16 16 16 16 16 16 16 16 1 1 16 16 16 1 1 16 16 16 16 16 1 1 1 1 1 1 16 16 16 16 16 16 16 1 1 1 1 1 1 1 16 16 16 16 16 16 16 16 16 16 16 16 16 16 1 1 1 16 16 16 16 16 16 16 16 16 16 16 16 16 16 16 16 16 16 16 16 16 16 16 16 16 16 16 16 16 16 16 16 16 16 16 16 16 16
16 16 16 16 16 16 16 16 16 16 16 16 1 1 16 16 16 16 16 1 1 16 16 16 16 16 16 16 1 1 1 1 1 16 1 1 1 1 1 1 1 16 16 16 16 16 16 16 16 16 16 16 16 16 1 1 1 1 1 16 16 16 16 16 16 16 16 16 16 16 16 16 16 16 16 16 16 16 16 16 16 16 16 16 16 16 16 16 16 16 16 16 16 16 16 16 16 16 16 16
16 16 16 16 16 16 16 16 16 16 16 16 1 16 16 16 16 16 16 16 1 16 16 16 16 16 16 16 16 1 1 1 1 1 1 1 16 16 16 1 1 16 16 16 16 16 16 1 1 1 1 1 1 1 16 16 16 16 16 16 16 16 16 16 16 16 16 16 16 16 16 16 16 16 16 16 16 16 16 16 16 16 16 16 16 16 16 16 1 16 16 16 16 16 16 16 16 16 16 16
16 16 16 16 16 16 16 16 16 16 16 1 1 16 16 16 16 16 16 1 1 16 16 16 16 16 1 1 1 1 1 1 1 16 16 16 1 1 1 1 1 1 1 1 1 1 1 16 16 16 16 16 16 16 12 10 10 10 10 10 10 10 10 10 10 10 10 10 10 10 10 10 10 10 10 16 16 16 16 16 16 16 16 16 16 16 16 16 1 1 16 16 16 16 16 16 16 16 16 16
16 16 16 16 16 16 16 16 16 16 1 1 16 16 16 16 1 1 1 1 16 16 16 16 16 16 16 16 1 1 1 1 1 1 1 1 1 1 1 16 16 16 16 16 16 16 16 16 16 16 16 12 10 10 11 3 3 3 3 3 3 3 3 3 3 3 3 3 3 3 3 3 3 3 3 3 1 16 16 16 16 16 16 16 16 16 16 16 16 1 16 16 16 16 16 16 16 16 16 16
1 1 1 1 1 1 1 16 16 16 1 16 16 1 1 1 16 16 16 16 16 16 16 16 16 16 16 1 1 16 1 1 1 1 1 16 16 16 16 16 16 16 16 16 16 16 16 16 16 12 10 11 3 3 3 3 3 4 5 5 6 3 3 3 3 3 4 5 5 5 5 5 5 5 5 6 1 1 16 16 16 16 16 16 16 16 16 16 16 1 1 16 16 16 16 16 16 16 16 16
1 1 1 1 1 1 1 1 1 1 1 16 1 1 16 16 16 16 16 16 16 16 16 16 16 16 16 1 16 1 1 16 16 16 1 1 16 16 16 16 16 16 16 16 16 16 16 16 16 8 3 3 3 3 3 3 4 15 16 16 14 5 6 3 3 3 3 20 21 21 21 21 21 21 21 22 16 1 1 1 16 16 16 16 16 16 16 16 16 16 1 16 16 16 16 16 16 16 16 16
16 16 16 16 1 1 1 1 1 1 1 1 1 1 1 16 16 16 16 16 16 16 16 16 16 16 16 1 1 16 16 16 16 16 16 1 16 16 16 16 16 16 16 16 16 16 12 10 10 11 3 3 3 3 3 3 7 16 16 16 16 2 8 3 3 3 3 23 18 18 18 18 18 18 18 24 16 1 1 1 1 16 16 16 16 16 16 16 16 16 1 1 16 16 16 16 16 16 16 16
16 16 16 16 16 16 16 16 1 1 1 1 1 1 1 1 1 1 1 16 16 16 1 16 16 16 1 1 16 16 16 16 16 16 16 16 1 16 16 16 16 16 16 16 16 16 8 3 3 3 3 4 5 6 3 3 9 10 10 10 10 10 11 3 3 3 3 23 18 18 18 18 18 19 18 24 1 1 1 1 1 1 16 16 16 16 16 16 16 16 16 1 16 16 16 16 16 16 16 16
16 16 16 16 16 16 16 16 16 1 16 1 1 1 1 1 1 1 1 1 1 1 1 1 16 16 1 16 16 16 16 16 16 16 16 16 16 16 16 16 16 16 12 10 10 10 11 3 3 4 5 15 16 14 6 3 3 3 3 3 3 3 3 3 3 3 20 31 18 18 18 19 18 18 18 24 1 1 1 1 1 1 1 1 1 16 16 16 1 1 1 1 1 1 16 16 16 16 16 16
16 16 16 16 16 16 16 16 16 1 1 16 16 1 1 1 1 1 1 1 1 1 1 1 1 1 1 16 16 16 16 16 16 16 16 16 16 16 16 16 16 16 8 3 3 3 3 4 5 15 16 16 16 16 14 5 5 5 5 5 5 6 3 3 7 20 31 18 18 18 18 18 18 18 18 24 16 16 16 1 1 1 1 16 16 16 16 1 1 16 16 16 1 1 16 16 16 16 16 16
16 16 16 16 16 16 16 16 16 16 1 16 16 1 1 16 16 16 1 1 1 1 1 1 1 1 1 1 1 1 16 16 16 16 16 16 16 16 16 16 12 10 11 3 3 3 3 7 16 16 16 16 16 16 16 16 16 16 16 16 16 8 3 3 7 23 18 18 18 18 18 18 18 18 18 24 16 16 16 2 2 17 1 1 16 16 16 1 16 16 16 16 1 16 16 16 16 16 16 16
16 16 16 16 16 16 16 16 16 16 16 1 1 16 16 16 16 16 16 16 16 16 1 1 1 1 1 1 1 1 1 1 16 16 16 16 16 16 16 16 8 3 3 3 3 4 5 15 16 16 16 16 16 16 16 16 16 16 16 16 16 8 3 3 7 23 18 18 18 18 19 18 18 18 18 24 16 16 16 2 2 17 17 1 16 16 16 1 16 16 16 16 1 1 16 16 16 16 16 16
16 16 16 16 16 16 16 16 1 1 1 1 1 16 16 16 16 16 16 16 16 16 16 16 1 1 1 1 1 1 1 1 1 16 16 16 16 16 16 12 11 3 3 3 4 15 16 16 16 16 16 16 16 16 16 16 16 16 16 16 16 8 3 3 7 23 18 18 18 18 18 18 18 18 18 30 21 21 21 21 22 17 17 1 1 16 16 1 16 16 16 16 16 1 16 16 16 16 16 16
16 16 16 16 16 16 1 1 1 16 16 16 1 16 16 16 16 16 16 16 16 16 16 16 1 16 1 16 16 1 1 1 1 1 16 16 16 16 12 11 3 3 3 4 15 16 16 16 1 1 1 1 1 16 16 16 16 16 16 16 16 8 3 3 7 23 18 18 18 18 18 17 17 17 17 18 18 18 18 18 24 17 17 16 1 16 16 1 16 16 16 16 16 1 16 16 16 16 16 16
16 16 16 16 16 1 1 16 16 16 16 16 16 1 16 16 16 16 16 16 16 16 16 1 1 16 1 16 16 16 16 1 1 1 1 16 16 12 11 3 3 4 5 15 16 16 16 1 1 16 16 16 16 1 1 16 16 16 16 16 16 8 3 3 7 23 18 18 18 18 18 17 17 17 17 18 18 18 18 18 24 17 17 16 1 16 16 1 1 16 16 16 16 1 16 16 16 16 16 16
16 16 16 16 1 1 16 16 16 16 16 16 16 16 1 16 16 16 16 16 16 16 16 1 16 16 1 16 16 16 16 16 1 1 1 1 1 8 3 3 3 7 16 16 16 16 1 1 16 16 16 16 16 16 1 1 16 16 16 16 16 8 3 3 7 23 18 18 19 18 18 17 17 17 17 17 17 17 17 17 17 17 17 16 1 16 1 16 1 1 16 16 16 1 16 16 16 16 16 16
16 16 16 16 1 16 16 16 16 16 16 16 16 16 1 16 16 16 16 16 16 16 1 1 16 16 1 16 16 16 16 16 16 1 1 1 1 1 3 3 3 7 16 16 16 1 1 1 16 16 16 16 16 16 16 1 16 16 16 16 16 8 3 3 7 23 18 18 18 18 18 17 17 17 17 17 17 17 17 17 17 17 17 16 16 1 1 16 16 16 1 1 16 1 16 16 16 16 16 1
16 16 16 16 1 16 16 16 16 16 16 16 16 16 1 1 1 1 16 16 16 16 1 16 16 16 1 16 16 16 16 16 16 16 16 1 10 11 3 3 4 15 16 16 1 1 1 1 16 16 16 16 16 16 16 1 16 16 16 16 16 8 3 3 7 25 26 26 29 18 18 17 17 17 17 18 18 18 18 28 27 17 17 16 16 1 16 16 16 16 16 1 1 1 16 16 16 16 16 1
16 16 16 16 1 16 16 1 1 1 1 1 1 1 1 1 16 16 1 16 16 1 16 16 16 1 1 16 16 16 16 16 16 16 12 1 3 3 3 4 15 16 16 16 1 1 1 1 16 16 16 16 16 16 16 1 1 16 16 16 16 8 3 3 9 10 10 13 23 18 18 17 17 17 17 18 18 18 18 24 17 17 17 16 16 1 16 16 16 16 16 16 16 1 1 16 16 16 16 1
16 16 16 16 1 16 1 1 16 16 16 16 1 1 1 1 1 16 1 16 16 1 16 16 16 1 16 16 16 16 16 16 16 12 11 3 3 3 3 7 16 16 16 1 1 1 1 1 16 16 16 16 16 1 1 16 1 16 16 16 16 8 3 3 3 3 3 7 23 18 18 18 18 18 18 18 18 19 18 24 17 17 17 16 16 1 16 16 16 16 16 16 16 1 1 1 16 16 16 1
16 16 16 16 1 1 1 16 16 16 1 1 1 1 1 1 1 16 1 1 16 1 16 16 16 1 16 16 16 16 16 16 16 8 3 3 3 3 4 15 16 16 16 1 16 1 1 16 16 16 16 1 1 16 1 16 1 16 16 16 16 8 3 3 3 3 3 7 25 26 26 29 18 18 18 18 18 18 18 24 17 17 17 16 1 1 16 16 16 16 16 16 16 1 16 1 16 16 16 1
16 16 16 16 1 16 1 1 1 1 1 1 16 1 1 16 1 16 1 16 16 1 16 16 16 1 16 16 16 16 16 16 16 11 3 3 3 3 7 16 16 16 16 1 16 1 1 16 16 16 16 1 16 1 16 16 1 16 16 16 16 8 3 3 3 3 3 3 3 3 7 25 18 18 18 18 18 18 18 24 17 17 17 16 1 1 16 16 16 16 16 16 16 1 16 1 16 16 16 1
16 16 16 16 16 16 16 1 16 16 1 1 1 1 1 16 1 1 1 16 16 1 16 16 1 1 16 16 16 16 16 12 11 3 3 3 3 3 7 16 16 16 1 1 1 1 16 16 16 16 1 16 16 1 16 16 1 1 16 16 16 8 3 3 3 3 3 3 3 3 3 3 23 18 18 18 19 18 18 24 17 17 17 1 1 1 16 16 16 16 16 16 16 16 16 1 1 16 16 1
16 16 16 16 16 16 1 16 1 16 1 1 1 1 16 1 1 1 16 16 16 1 16 1 1 16 16 16 16 16 16 8 3 3 3 3 3 3 7 16 16 16 1 1 1 16 16 16 16 1 1 16 16 1 16 16 16 1 16 16 16 14 5 6 3 3 3 3 3 3 3 3 25 26 26 26 26 26 26 27 17 17 17 1 1 16 16 16 16 16 16 16 16 16 16 16 1 16 16 1
16 16 16 16 16 16 1 1 1 1 1 1 1 1 1 1 1 1 16 16 16 16 1 1 16 16 16 16 16 16 12 11 3 3 3 3 3 4 15 16 16 16 1 1 16 16 16 16 16 1 16 1 1 1 1 16 16 1 16 16 16 16 1 14 5 5 5 6 3 3 3 3 3 3 3 3 3 3 3 3 17 17 1 1 1 16 16 16 16 16 16 16 16 16 16 16 1 16 16 1
16 16 16 16 16 16 16 1 1 1 1 1 1 1 1 16 16 1 16 16 16 16 16 16 16 16 16 16 16 16 8 3 3 3 3 3 4 15 16 16 16 1 1 16 16 16 16 16 16 1 16 1 16 16 1 16 16 1 1 16 16 16 16 16 16 16 16 14 5 5 5 5 6 3 3 3 3 3 3 3 17 17 1 1 16 16 16 16 16 16 16 16 16 16 16 16 1 16 1 1
16 16 16 16 16 16 16 16 16 16 1 1 1 1 16 16 16 1 1 16 16 16 16 16 16 16 16 16 16 16 8 3 3 3 4 5 15 16 16 16 16 1 1 1 16 16 16 16 1 1 1 16 16 16 1 1 1 16 1 16 16 16 16 16 16 16 16 16 16 16 16 16 14 5 5 5 5 5 5 5 5 1 1 1 16 16 16 16 16 1 1 1 1 16 16 16 1 16 1 16
16 16 16 16 16 16 16 16 16 16 1 1 1 16 16 16 16 16 1 16 1 16 16 16 16 16 16 16 16 16 8 3 3 3 7 16 16 16 16 1 1 1 1 16 1 16 16 16 1 1 16 16 16 16 1 1 16 16 1 1 16 16 1 1 1 1 1 1 16 16 16 16 16 16 16 16 16 16 16 16 1 1 16 16 16 16 16 16 1 1 16 16 1 16 16 16 1 16 1 16
16 16 16 16 16 16 16 16 16 1 1 1 1 16 16 16 16 16 16 1 1 16 16 16 16 16 16 16 16 12 11 3 3 4 15 16 16 16 1 1 16 1 1 1 1 1 16 16 1 16 16 16 16 1 1 16 16 16 16 1 16 16 1 16 16 16 16 1 16 16 16 16 16 16 16 16 16 16 1 1 1 16 16 16 16 16 1 1 16 16 16 16 16 16 16 16 1 16 1 16
16 16 16 16 16 16 16 16 16 1 1 1 1 16 16 16 16 16 16 16 1 16 16 16 16 16 16 16 16 8 3 3 3 7 16 16 1 1 1 1 16 1 16 1 1 1 16 16 1 16 16 16 1 1 1 16 16 16 16 1 1 16 1 1 16 16 16 16 1 1 16 16 1 1 16 16 16 16 1 16 16 16 16 1 1 1 16 16 16 16 16 16 16 16 16 16 1 16 1 16
10 10 10 10 13 16 16 16 16 16 1 1 1 16 16 16 16 16 16 16 16 16 16 16 16 16 16 16 12 11 3 3 3 7 16 1 1 16 1 16 1 16 16 1 1 1 16 16 1 1 16 16 1 1 16 16 16 16 16 16 1 16 16 1 16 16 16 16 16 1 1 1 1 1 1 16 16 16 16 16 16 16 1 1 16 16 16 16 16 16 16 16 16 16 16 16 1 1 1 16
3 3 3 3 9 10 10 13 16 16 16 16 16 16 16 16 16 16 16 16 16 16 16 16 16 16 16 16 8 3 3 3 4 15 1 1 16 16 16 1 1 16 16 1 1 1 16 16 1 1 1 1 1 16 16 16 16 16 1 1 1 1 1 1 1 1 1 1 1 16 16 1 1 1 1 1 16 16 16 16 16 1 1 16 16 16 16 16 16 3 3 3 16 16 16 16 16 1 16 16
3 3 3 3 3 3 3 9 10 10 10 10 13 16 16 16 16 16 16 16 16 16 16 16 16 16 16 16 8 3 3 3 7 1 1 1 16 16 16 1 1 1 1 1 1 16 16 1 1 16 16 1 16 16 16 16 16 16 16 1 1 16 16 16 1 16 16 1 1 1 1 1 1 1 1 1 1 1 16 16 1 1 16 16 16 16 16 16 3 3 2 3 3 3 16 16 16 1 16 16
3 3 3 3 3 3 3 3 3 3 3 3 9 10 10 10 10 10 13 16 16 16 16 16 16 16 16 12 11 3 3 3 7 1 1 16 16 16 16 16 1 1 1 1 16 16 1 1 1 16 16 1 1 16 16 16 16 16 16 16 16 1 16 1 1 16 1 1 16 16 16 16 1 16 1 1 1 1 1 1 1 16 16 16 16 16 3 3 3 3 3 3 3 3 3 16 16 1 1 16
2 2 2 2 2 3 3 3 3 3 3 3 3 3 3 3 3 3 9 10 10 10 10 10 10 10 10 11 3 3 3 4 15 1 16 1 1 1 1 1 1 1 1 16 16 16 1 1 16 1 16 16 16 16 16 16 16 16 16 16 16 1 1 1 16 16 1 16 16 16 16 1 1 16 1 16 16 16 16 16 1 1 1 16 16 16 3 3 3 3 3 3 3 3 3 16 16 1 1 16
2 2 2 2 2 2 2 2 3 3 3 3 3 3 3 3 3 3 3 3 3 3 3 3 3 3 3 3 3 3 3 7 16 1 1 1 16 16 1 1 1 1 1 16 16 16 16 1 1 1 1 1 16 16 16 16 16 1 1 1 1 1 16 1 16 16 1 16 16 1 1 1 16 1 1 16 16 16 16 1 1 1 16 16 16 16 3 3 3 3 3 3 3 3 3 16 16 1 1 1
2 2 2 2 2 2 2 2 2 2 2 2 2 2 2 3 3 3 3 3 3 3 3 3 3 3 3 3 3 3 3 9 10 10 16 16 16 16 16 16 16 16 16 16 16 16 16 16 1 1 1 1 1 16 16 1 1 1 16 16 16 16 16 16 1 1 1 1 1 1 16 16 16 1 16 1 16 1 1 1 16 16 16 16 16 16 3 3 3 3 3 3 3 3 3 16 16 1 16 1
2 2 2 2 2 2 2 2 2 2 2 2 2 2 2 2 2 2 2 3 3 3 3 3 3 2 2 2 3 3 3 3 3 3 3 3 3 16 16 16 16 16 16 16 16 16 16 16 16 1 1 16 1 1 1 1 1 1 16 16 16 16 16 16 16 16 1 1 1 16 16 16 16 1 16 1 1 16 16 16 16 16 16 16 16 3 3 3 3 3 3 3 3 3 3 16 16 1 16 1
2 2 2 2 2 2 2 2 2 2 2 2 2 2 2 2 2 2 2 2 2 2 2 2 2 2 2 2 3 3 2 2 2 2 3 3 3 3 3 3 3 3 16 16 16 16 16 16 16 16 16 16 16 16 16 16 16 1 1 1 1 16 16 16 16 16 1 16 1 16 16 1 1 1 16 16 1 16 16 16 16 16 3 3 3 3 3 3 3 3 3 3 3 3 16 16 16 1 1 1
2 2 2 2 2 2 2 2 2 2 2 2 2 2 2 2 2 2 2 2 2 2 2 2 2 2 2 2 3 3 2 2 2 2 2 2 2 3 3 3 3 3 3 3 3 3 16 16 16 16 16 16 16 16 16 16 16 16 16 16 1 1 16 16 16 16 1 16 16 1 1 1 1 1 1 1 1 16 16 16 16 3 3 3 3 3 3 3 3 3 3 3 3 16 16 16 16 16 1 1
2 2 2 2 2 2 2 2 2 2 2 2 2 2 2 2 2 2 2 2 2 2 2 2 2 2 2 2 3 3 2 2 2 2 2 2 2 2 2 2 2 3 3 3 3 3 3 3 3 16 16 16 16 16 16 16 16 16 16 16 16 16 16 16 16 16 1 16 16 16 1 1 1 1 1 16 16 16 16 16 3 3 3 3 3 3 3 16 16 16 16 16 16 16 16 16 16 16 1 16
2 2 2 2 2 2 2 2 2 2 2 2 2 2 2 2 2 2 2 2 2 2 2 2 2 2 2 3 3 2 2 2 2 2 2 2 2 2 2 2 2 2 2 2 2 3 3 3 3 3 3 3 16 16 16 16 16 16 16 16 16 16 16 16 16 16 1 1 16 1 1 16 1 16 1 16 16 3 3 3 3 3 3 3 3 16 16 16 16 16 16 16 16 16 16 16 16 1 1 16
2 2 2 2 2 2 2 2 2 2 2 2 2 2 2 2 2 2 2 2 2 2 2 2 2 2 2 3 3 2 2 2 2 2 2 2 2 2 2 2 2 2 2 2 2 2 2 2 3 3 3 3 3 3 3 16 16 16 16 16 16 16 16 16 16 16 16 16 1 1 16 16 1 16 1 3 3 3 3 3 3 3 16 16 16 16 16 16 16 16 16 16 16 16 16 16 16 1 16 16
2 2 2 2 2 2 2 2 2 2 2 2 2 2 2 2 2 2 2 2 2 2 2 2 2 2 2 3 3 2 2 2 2 2 2 2 2 2 2 2 2 2 2 2 2 2 2 2 2 2 2 2 3 3 3 3 3 3 3 16 16 16 16 16 1 1 1 1 1 16 16 1 3 3 3 3 3 3 16 16 16 16 16 16 16 16 16 16 16 16 16 16 16 16 1 1 1 1 16 16
2 2 2 2 2 2 2 2 2 2 2 2 2 2 2 2 2 2 2 2 2 2 2 2 2 2 3 3 2 2 2 2 2 2 2 2 2 2 2 2 2 2 2 2 2 2 2 2 2 2 2 2 2 2 2 3 3 3 3 3 3 3 3 16 16 1 1 1 16 1 1 3 3 3 3 3 16 16 16 16 16 16 16 16 16 1 1 1 1 16 16 1 1 1 1 16 16 16 16 16
2 2 2 2 2 2 2 2 2 2 2 2 2 2 2 2 2 2 2 2 2 2 2 2 2 2 3 3 2 2 2 2 2 2 2 2 2 2 2 2 2 2 2 2 2 2 2 2 2 2 2 2 2 2 2 2 2 2 2 3 3 3 3 3 3 3 1 1 1 3 3 3 3 3 3 16 16 16 16 16 16 16 16 16 16 1 16 16 1 1 1 1 16 16 16 16 16 16 16 16
2 2 2 2 2 2 2 2 2 2 2 2 2 2 2 2 2 2 2 2 2 2 2 2 2 2 3 3 2 2 2 2 2 2 2 2 2 2 2 2 2 2 2 2 2 2 2 2 2 2 2 2 2 2 20 21 21 21 22 2 2 2 2 3 3 3 3 3 3 3 3 3 16 16 16 16 16 16 16 16 16 16 16 16 16 16 1 1 16 16 16 16 16 16 16 16 16 16 16 16
2 2 2 2 2 2 2 2 2 2 2 2 2 2 2 2 2 2 2 2 2 2 2 2 2 3 3 2 2 2 2 2 2 2 2 2 2 2 2 2 2 16 16 16 16 16 2 2 2 2 2 2 2 2 23 18 18 18 24 2 2 2 2 2 2 2 3 3 3 3 3 3 3 3 3 16 16 16 16 16 16 16 16 16 16 16 16 1 1 16 16 16 16 16 16 16 16 16 16 16
2 2 2 2 2 2 2 2 2 2 2 2 2 2 2 2 2 2 2 2 2 2 2 2 2 3 3 2 2 2 2 2 2 2 2 2 2 2 16 16 16 16 16 16 16 16 2 2 2 2 2 2 2 2 23 18 18 18 30 21 21 21 21 21 21 21 22 2 3 3 3 3 3 3 3 3 16 16 16 16 16 16 16 16 16 16 16 16 1 1 1 16 16 16 16 16 16 16 16 16
2 2 2 2 2 2 2 2 2 2 2 2 2 2 2 2 2 2 2 2 2 2 2 2 2 3 3 2 2 2 2 2 2 2 2 2 2 1 1 16 16 16 16 16 16 16 2 2 2 1 2 2 2 2 23 18 18 18 18 18 18 18 18 18 18 18 30 21 21 21 21 22 3 3 3 3 3 3 3 3 3 3 3 3 3 3 16 16 16 16 1 1 16 16 16 16 16 16 16 16
2 2 2 2 2 2 2 2 2 2 2 2 2 2 2 2 2 2 2 2 2 2 2 8 3 3 7 2 2 2 2 2 2 2 2 2 2 1 16 1 1 16 16 16 16 16 16 16 16 1 16 16 2 2 25 29 18 18 18 18 18 18 18 18 18 18 18 18 18 18 18 30 22 3 3 3 3 3 3 3 3 3 3 3 3 3 3 3 3 16 16 16 1 1 16 16 16 16 16 16
2 2 2 2 2 2 2 2 2 2 2 2 2 2 2 2 2 2 2 2 2 2 2 8 3 3 7 2 2 2 2 2 2 2 2 2 2 2 16 16 1 16 16 16 16 16 16 16 16 1 16 16 16 16 16 25 29 18 18 19 18 18 18 18 18 18 18 18 18 18 18 18 24 3 3 2 2 2 2 2 2 2 2 3 3 3 3 3 3 3 3 16 16 1 1 16 16 16 16 16
2 2 2 2 2 2 2 2 2 2 2 2 2 2 2 2 2 2 2 2 2 2 2 8 3 3 7 2 2 2 2 2 2 2 2 2 2 2 16 16 1 16 16 16 16 16 16 16 16 1 1 16 16 16 16 16 25 29 18 18 18 18 18 18 19 18 18 18 18 18 18 18 24 3 3 2 2 2 2 2 2 2 2 2 2 2 2 3 3 3 3 3 3 16 1 1 16 16 16 16
2 2 2 2 2 2 2 2 2 2 2 2 2 2 2 2 2 2 2 2 2 2 2 8 3 3 7 2 2 2 2 2 2 2 2 2 2 2 16 16 1 1 16 16 16 16 16 16 16 16 1 16 16 16 16 16 16 25 29 18 18 18 18 18 18 18 18 18 18 28 26 26 27 3 3 2 2 2 2 2 2 2 2 2 2 2 2 2 2 3 3 3 3 3 1 1 1 16 16 16
2 2 2 2 2 2 2 2 2 2 2 2 2 2 2 2 2 2 2 2 2 2 2 8 3 3 7 2 2 2 2 2 2 2 2 2 2 2 16 16 16 1 1 1 1 16 16 16 16 16 1 1 16 16 16 16 16 16 25 29 18 18 18 18 18 18 19 18 18 24 16 16 8 3 3 2 2 2 2 2 2 2 2 2 2 2 2 2 2 2 3 3 3 3 1 1 1 1 16 16
2 2 2 2 2 2 2 2 2 2 2 2 2 2 2 2 2 2 2 2 2 2 2 8 3 3 7 2 2 2 2 2 2 2 2 2 2 16 16 16 16 16 16 16 1 1 16 16 16 16 16 1 16 16 16 16 16 16 16 25 26 29 18 18 18 18 18 18 18 24 16 16 8 3 3 2 2 2 2 2 2 2 2 2 2 2 2 2 2 2 2 2 3 3 3 1 1 1 16 16
2 2 2 2 2 2 2 2 2 2 2 2 2 2 2 2 2 2 2 2 2 2 2 8 3 3 7 2 2 2 2 2 2 2 2 2 2 16 16 16 16 16 16 16 16 1 16 16 16 16 1 1 16 16 16 16 16 16 16 16 16 25 26 26 29 18 18 18 18 24 16 16 8 3 3 2 2 2 2 2 2 2 2 2 2 2 2 2 2 2 2 2 2 3 3 3 3 16 16 16
2 2 2 2 2 2 2 2 2 2 2 2 2 2 2 2 2 2 2 2 2 2 2 8 3 3 7 2 2 2 2 2 2 2 2 2 16 16 16 16 16 16 16 16 16 16 1 1 1 1 1 1 1 1 16 16 16 16 16 16 16 16 16 16 23 18 18 18 18 24 16 16 8 3 3 2 2 2 2 2 2 2 2 2 2 2 2 2 2 2 2 2 2 2 3 3 3 3 16 16
2 2 2 2 2 2 2 2 2 2 2 2 2 2 2 2 2 2 2 2 2 2 2 8 3 3 7 2 2 2 2 2 2 2 2 2 16 16 16 16 16 16 16 16 16 16 16 16 16 1 1 16 16 1 16 16 16 16 16 16 16 16 16 16 23 18 18 18 19 24 16 16 8 3 3 2 2 2 2 2 2 2 2 2 2 2 2 2 2 2 2 2 2 2 2 3 3 3 3 16
2 2 2 2 2 2 2 2 2 2 2 2 2 2 2 2 2 2 2 2 2 2 2 8 3 3 7 2 2 2 2 2 2 2 2 16 16 16 16 16 16 16 16 16 16 16 16 16 16 16 16 1 1 1 16 16 16 16 16 16 16 16 16 16 23 18 18 18 28 27 16 16 8 3 3 2 2 2 2 2 2 2 2 2 2 2 2 2 2 2 2 2 2 2 2 2 3 3 3 3
2 2 2 2 2 2 2 2 2 2 2 2 2 2 2 2 2 2 2 2 2 2 2 8 3 3 7 2 2 2 2 2 2 2 2 16 32 32 32 32 32 32 32 32 32 32 16 16 16 1 1 1 16 16 16 16 16 16 16 16 16 16 16 16 23 18 18 18 24 16 16 16 8 3 3 2 2 2 2 2 2 2 2 2 2 2 2 2 2 2 2 2 2 2 2 2 2 3 3 3
2 2 2 2 2 2 2 2 2 2 2 2 2 2 2 2 2 2 2 2 2 2 2 8 3 3 7 2 2 2 2 2 2 2 2 16 32 34 34 34 34 34 34 34 34 32 16 16 1 1 16 16 16 16 16 16 16 16 16 16 16 16 16 16 23 18 18 18 30 21 22 16 8 3 3 2 2 2 2 2 2 2 2 2 2 2 2 2 2 2 2 2 2 2 2 2 2 2 3 3
2 2 2 2 2 2 2 2 2 2 2 2 2 2 2 2 2 2 2 2 2 2 2 8 3 3 7 2 2 2 2 2 2 2 2 16 32 34 34 34 34 34 34 34 34 32 16 16 1 16 16 16 16 16 16 16 16 16 16 16 16 16 16 16 23 18 18 18 18 18 24 16 8 3 3 2 2 2 2 2 2 2 2 2 2 2 2 2 2 2 2 2 2 2 2 2 2 2 2 3
2 2 2 2 2 2 2 2 2 2 2 2 2 2 2 2 2 2 2 2 2 2 2 8 3 3 7 2 2 2 2 2 2 2 2 16 32 34 34 34 34 34 34 34 34 32 16 16 1 16 16 16 16 16 16 16 16 16 16 16 16 16 16 16 23 18 18 18 18 18 24 16 8 3 3 2 2 2 2 2 2 2 2 2 2 2 2 2 2 2 2 2 2 2 2 2 2 2 2 3
10 10 10 10 10 10 10 10 10 10 10 10 10 10 10 10 10 10 10 10 10 10 10 11 3 3 9 10 10 10 10 10 10 10 10 16 32 34 34 34 34 34 34 34 34 32 16 16 1 16 16 3 3 3 3 3 3 3 3 16 16 16 16 16 23 19 18 18 18 19 24 16 8 3 3 2 2 2 2 2 2 2 2 2 2 2 2 2 2 2 2 2 2 2 2 2 2 2 2 2
3 3 3 3 3 3 3 3 3 3 3 3 3 3 3 3 3 3 3 3 3 3 3 3 3 3 3 3 3 3 3 3 3 3 3 3 3 34 34 34 34 34 34 34 34 32 16 16 1 16 3 3 3 3 3 3 3 3 3 16 16 16 16 16 23 18 18 18 18 18 24 16 8 3 3 2 2 2 2 2 2 2 2 2 2 2 2 2 2 2 2 2 2 2 2 2 2 2 2 2
3 3 3 3 3 3 3 3 3 3 3 3 3 3 3 3 3 3 3 3 3 3 3 3 3 3 3 3 3 3 3 3 3 3 3 3 3 34 34 34 34 34 34 34 34 32 16 16 1 16 3 3 3 3 3 3 3 3 3 16 16 16 16 16 23 18 18 18 18 18 24 16 8 3 3 2 2 2 2 2 2 2 2 2 2 2 2 2 2 2 2 2 2 2 2 2 2 2 2 2
5 5 5 5 5 5 5 5 5 5 5 5 5 5 5 5 5 5 5 5 5 5 5 6 3 3 7 2 2 2 2 2 2 2 2 16 32 34 34 34 34 34 34 34 34 32 16 16 1 16 3 3 3 3 3 3 3 3 3 16 16 16 16 16 23 18 18 18 18 18 24 16 8 3 3 2 2 2 2 2 2 2 2 2 2 2 2 2 2 2 2 2 2 2 2 2 2 2 2 2
2 2 2 2 2 2 2 2 2 2 2 2 2 2 2 2 2 2 2 2 2 2 2 8 3 3 7 2 2 2 2 2 2 2 2 16 32 34 34 34 34 34 34 34 34 32 16 16 1 16 3 3 3 3 3 3 3 3 16 16 16 16 16 16 23 18 18 18 18 18 24 16 8 3 3 2 2 2 2 2 2 2 2 2 2 2 2 2 2 2 2 2 2 2 2 2 2 2 2 2
2 2 2 2 2 2 2 2 2 2 2 2 2 2 2 2 2 2 2 2 2 2 2 8 3 3 7 2 2 2 2 2 2 2 2 16 32 34 34 34 34 34 34 34 34 32 16 16 16 16 3 3 3 3 3 16 16 16 16 16 16 16 16 16 23 18 19 18 18 18 24 16 8 3 3 2 2 2 2 2 2 2 2 2 2 2 2 2 2 2 2 2 2 2 2 2 2 2 2 2
2 2 2 2 2 2 2 2 2 2 2 2 2 2 2 2 2 2 2 2 2 2 2 8 3 3 7 2 2 2 2 2 2 2 2 2 32 34 34 34 34 34 34 34 34 32 16 16 16 16 3 3 3 3 16 16 16 16 16 16 16 16 16 20 31 18 18 18 18 18 24 16 8 3 3 2 2 2 2 2 2 2 2 2 2 2 2 2 2 2 2 2 2 2 2 2 2 2 2 2
2 2 2 2 2 2 2 2 2 2 2 2 2 2 2 2 2 2 2 2 2 2 2 8 3 3 7 2 2 2 2 2 2 2 2 2 32 32 32 32 32 32 32 32 32 32 16 16 16 3 3 3 3 16 16 16 16 16 16 16 16 16 16 18 18 18 18 18 18 28 27 16 8 3 3 2 2 2 2 2 2 2 2 2 2 2 2 2 2 2 2 2 2 2 2 2 2 2 2 2
2 2 2 2 2 2 2 2 2 2 2 2 2 2 2 2 2 2 2 2 2 2 2 8 3 3 7 2 2 2 2 2 2 2 2 2 2 2 2 16 16 16 16 16 16 16 16 16 3 3 3 3 16 16 16 16 16 16 16 16 16 20 21 18 18 18 18 18 18 24 16 16 8 3 3 2 2 2 2 2 2 2 2 2 2 2 2 2 2 2 2 2 2 2 2 2 2 2 2 2
2 2 2 2 2 2 2 2 2 2 2 2 2 2 2 2 2 2 2 2 2 2 2 8 3 3 7 2 2 2 2 2 2 2 2 2 2 2 2 2 16 16 16 16 16 16 16 16 3 3 3 16 16 16 16 16 16 16 16 16 16 23 18 18 18 18 18 18 18 24 16 16 8 3 3 2 2 2 2 2 2 2 2 2 2 2 2 2 2 2 2 2 2 2 2 2 2 2 2 2
2 2 2 2 2 2 2 2 2 2 2 2 2 2 2 2 2 2 2 2 2 2 2 8 3 3 7 2 2 2 2 2 2 2 2 2 2 2 2 2 2 16 16 16 16 16 16 16 3 3 3 16 16 16 16 16 16 20 21 21 21 31 18 18 19 18 18 18 18 24 16 16 8 3 3 2 2 2 2 2 2 2 2 2 2 2 2 2 2 2 2 2 2 2 2 2 2 2 2 2
2 2 2 2 2 2 2 2 2 2 2 2 2 2 2 2 2 2 2 2 2 2 2 8 3 3 7 2 2 2 2 2 2 2 2 2 2 2 2 2 2 2 16 16 16 16 16 16 3 3 16 16 16 16 16 16 20 31 19 18 18 18 18 18 18 18 18 18 18 24 16 16 8 3 3 2 2 2 2 2 2 2 2 2 2 2 2 2 2 2 2 2 2 2 2 2 2 2 2 2
2 2 2 2 2 2 2 2 2 2 2 2 2 2 2 2 2 2 2 2 2 2 2 8 3 3 7 2 2 2 2 2 2 2 2 2 2 2 2 2 2 2 2 2 16 16 16 16 3 3 16 16 16 16 16 20 31 18 18 18 18 19 18 18 18 18 18 18 18 24 16 16 8 3 3 2 2 2 2 2 2 2 2 2 2 2 2 2 2 2 2 2 2 2 2 2 2 2 2 2
2 2 2 2 2 2 2 2 2 2 2 2 2 2 2 2 2 2 2 2 2 2 2 8 3 3 7 2 2 2 2 2 2 2 2 2 2 2 2 2 2 2 2 2 2 2 2 2 3 3 16 16 2 2 20 31 18 18 18 18 18 18 18 28 26 26 26 26 26 27 16 16 8 3 3 2 2 2 2 2 2 2 2 2 2 2 2 2 2 2 2 2 2 2 2 2 2 2 2 2
2 2 2 2 2 2 2 2 2 2 2 2 2 2 2 2 2 2 2 2 2 2 2 8 3 3 7 2 2 2 2 2 2 2 2 2 2 2 2 2 2 2 2 2 2 2 2 2 3 3 2 2 2 2 23 19 18 18 18 18 18 18 19 24 16 16 16 16 16 16 16 16 16 3 3 2 2 2 2 2 2 2 2 2 2 2 2 2 2 2 2 2 2 2 2 2 2 2 2 2
2 2 2 2 2 2 2 2 2 2 2 2 2 2 2 2 2 2 2 2 2 2 2 8 3 3 7 2 2 2 2 2 2 2 2 2 2 2 2 2 2 2 2 2 2 2 2 2 3 3 2 2 2 2 23 18 18 18 18 18 18 28 26 27 2 2 2 2 2 2 2 2 2 3 3 2 2 2 2 2 2 2 2 2 2 2 2 2 2 2 2 2 2 2 2 2 2 2 2 2
2 2 2 2 2 2 2 2 2 2 2 2 2 2 2 2 2 2 2 2 2 2 2 8 3 3 7 2 2 2 2 2 2 2 2 2 2 2 2 2 2 2 2 2 2 2 2 2 3 3 2 2 2 2 23 18 18 18 18 18 18 24 2 2 2 3 3 3 3 3 3 3 3 3 3 3 3 2 2 2 2 2 2 2 2 2 2 2 2 2 2 2 2 2 2 2 2 2 2 2
2 2 2 2 2 2 2 2 2 2 2 2 2 2 2 2 2 2 2 2 2 2 2 8 3 3 7 2 2 2 2 2 2 2 2 2 2 2 2 2 2 2 2 2 2 2 2 2 3 3 2 2 2 2 25 26 26 26 26 26 26 27 3 3 3 3 3 3 3 3 3 3 3 3 3 3 3 3 3 2 2 2 2 2 2 2 2 2 2 2 2 2 2 2 2 2 2 2 2 2
2 2 2 2 2 2 2 2 2 2 2 2 2 2 2 2 2 2 2 2 2 2 2 8 3 3 7 2 2 2 2 2 2 2 2 2 2 2 2 2 2 2 2 2 2 2 2 2 3 3 2 2 2 2 2 2 2 2 3 3 3 3 3 3 3 3 2 2 2 2 2 2 2 2 2 2 3 3 3 3 2 2 2 2 2 2 2 2 2 2 2 2 2 2 2 2 2 2 2 2
2 2 2 2 2 2 2 2 2 2 2 2 2 2 2 2 2 2 2 2 2 2 2 8 3 3 7 2 2 2 2 2 2 2 2 2 2 2 2 2 2 2 2 2 2 2 2 2 3 3 2 2 2 3 3 3 3 3 3 3 3 3 2 2 2 2 2 2 2 2 2 2 2 2 2 2 2 2 3 3 3 2 2 2 2 2 2 2 2 2 2 2 2 2 2 2 2 2 2 2
2 2 2 2 2 2 2 2 2 2 2 2 2 2 2 2 2 2 2 2 2 2 2 8 3 3 7 2 2 2 2 2 2 2 2 2 2 2 2 2 2 2 2 2 2 2 2 2 3 3 3 3 3 3 3 3 3 3 2 2 2 2 2 2 2 2 2 2 2 2 2 2 2 2 2 2 2 2 2 2 3 3 3 2 2 2 2 2 2 2 2 2 2 2 2 2 2 2 2 2
2 2 2 2 2 2 2 2 2 2 2 2 2 2 2 2 2 2 2 2 2 2 1 8 3 3 7 2 2 2 2 2 2 2 2 2 2 2 2 2 2 2 2 2 2 2 2 2 3 3 3 3 3 3 2 2 2 2 2 2 2 2 2 2 2 2 2 2 2 2 2 2 2 2 2 2 2 2 2 2 2 3 3 3 3 2 2 2 2 2 2 2 2 2 2 2 2 2 2 2
2 2 2 2 2 2 2 2 2 2 2 2 2 2 2 2 2 2 2 2 2 2 1 8 3 3 7 2 2 2 2 2 2 2 2 2 2 2 2 2 2 2 2 2 2 3 3 3 3 3 3 3 2 2 2 2 2 2 2 2 2 2 2 2 2 2 2 2 2 2 2 2 2 2 2 2 2 2 2 2 2 2 2 3 3 3 2 2 2 2 2 2 2 2 2 2 2 2 2 2
2 2 2 2 2 2 2 2 2 2 2 2 2 2 2 2 2 2 2 2 2 2 1 8 3 3 7 2 2 2 2 2 2 2 2 2 2 2 2 2 2 2 2 3 3 3 3 3 2 2 2 2 2 2 2 2 2 2 2 2 2 2 2 2 2 2 2 2 2 2 2 2 2 2 2 2 2 2 2 2 2 2 2 2 3 3 3 3 2 2 2 2 2 2 2 2 2 2 2 2
2 2 2 2 2 2 2 2 2 2 2 2 2 2 2 2 2 2 2 2 2 2 1 8 3 3 7 2 2 2 2 2 2 2 2 2 2 2 2 2 2 2 3 3 3 3 2 2 2 2 2 2 2 2 2 2 2 2 2 2 2 2 2 2 2 2 2 2 2 2 2 2 2 2 2 2 2 2 2 2 2 2 2 2 2 2 3 3 3 3 2 2 2 2 2 2 2 2 2 2
2 2 2 2 2 2 2 2 2 2 2 2 2 2 2 2 2 2 2 2 2 2 2 8 3 3 7 2 2 2 2 2 2 2 2 2 2 2 2 2 3 3 3 3 2 2 2 2 2 2 2 2 2 2 2 2 2 2 2 2 2 2 2 2 2 2 2 2 2 2 2 2 2 2 2 2 2 2 2 2 2 2 2 2 2 2 2 2 3 3 3 2 2 2 2 2 2 2 2 2
2 2 2 2 2 2 2 2 2 2 2 2 2 2 2 2 2 2 2 2 2 2 2 8 3 3 7 2 2 2 2 2 2 2 2 2 2 2 3 3 3 3 2 2 2 2 2 2 2 2 2 2 2 2 2 2 2 2 2 2 2 2 2 2 2 2 2 2 2 2 2 2 2 2 2 2 2 2 2 2 2 2 2 2 2 2 2 2 2 3 3 3 2 2 2 2 2 2 2 2
2 2 2 2 2 2 2 2 2 2 2 2 2 2 2 2 2 2 2 2 2 2 2 8 3 3 7 2 2 2 2 2 2 2 2 2 3 3 3 3 3 2 2 2 2 2 2 2 2 2 2 2 2 2 2 2 2 2 2 2 2 2 2 2 2 2 2 2 2 2 2 2 2 2 2 2 2 2 2 2 2 2 2 2 2 2 2 2 2 2 2 3 3 3 2 2 2 2 2 2
2 2 2 2 2 2 2 2 2 2 2 2 2 2 2 2 2 2 2 2 2 2 2 8 3 3 9 10 10 10 10 10 10 10 3 3 3 3 3 2 2 2 2 2 2 2 2 2 2 2 2 2 2 2 2 2 2 2 2 2 2 2 2 2 2 2 2 2 2 2 2 2 2 2 2 2 2 2 2 2 2 2 2 2 2 2 2 2 2 2 2 2 3 3 3 2 2 2 2 2
2 2 2 2 2 2 2 2 2 2 2 2 2 2 2 2 2 2 2 2 2 2 2 8 3 3 3 3 3 3 3 3 3 3 3 3 3 3 2 2 2 2 2 2 2 2 2 2 2 2 2 2 2 2 2 2 2 2 2 2 2 2 2 2 2 2 2 2 2 2 2 2 2 2 2 2 2 2 2 2 2 2 2 2 2 2 2 2 2 2 2 2 2 2 3 3 3 2 2 2
2 2 2 2 2 2 2 2 2 2 2 2 2 2 2 2 2 2 2 2 2 2 2 8 3 3 3 3 3 3 3 3 3 3 3 3 3 2 2 2 2 2 2 2 2 2 2 2 2 2 2 2 2 2 2 2 2 2 2 2 2 2 2 2 2 2 2 2 2 2 2 2 2 2 2 2 2 2 2 2 2 2 2 2 2 2 2 2 2 2 2 2 2 2 2 2 3 3 3 3
